13 13 13 13 13 13 13 13 13 13 13 13 13 13 13 13 13 13 13 13 13 13 13 13 13 13 13 13 13 13 13 13 13 13 13 13 13 13 13 13 13 13 13 13 13 13 13 13 13 13
13 13 13 13 13 13 13 13 13 13 13 13 13 13 13 13 13 13 13 13 13 13 13 13 13 13 13 13 13 13 13 13 13 13 13 13 13 13 13 13 13 13 13 13 13 13 13 13 13 13
13 13 13 13 13 13 13 13 13 13 13 13 13 13 13 13 13 13 13 13 17 18 18 18 18 18 21 13 13 13 13 13 13 13 13 13 13 13 13 13 13 13 13 13 13 13 13 13 13 13
13 13 13 13 13 13 13 13 13 13 13 13 13 13 13 13 13 13 13 13 19 12 12 12 12 12 20 13 13 13 13 13 13 13 13 13 13 13 13 13 13 13 13 13 13 13 13 13 13 13
13 13 13 13 13 13 13 13 13 13 13 13 13 13 13 13 13 13 13 13 19 12 12 12 12 12 20 13 13 13 13 13 13 13 13 13 13 13 13 13 13 13 13 13 13 13 13 13 13 13
13 13 13 13 13 13 13 13 13 13 13 13 13 13 13 13 13 13 13 13 19 12 12 12 12 12 20 13 13 13 13 13 13 13 13 13 13 13 13 13 13 13 13 13 13 13 13 13 13 13
13 13 13 13 13 13 13 13 11 11 11 11 11 13 13 13 13 13 13 13 22 23 23 23 23 23 24 13 13 13 13 13 13 13 13 13 13 13 13 13 13 13 13 13 13 13 13 13 13 13
13 13 13 13 13 13 13 13 11 13 13 13 11 13 13 13 13 13 13 13 10 10 10 10 10 10 10 10 10 10 10 10 10 10 10 10 25 10 10 25 10 13 13 13 13 13 13 13 13 13
13 13 13 13 13 13 13 13 11 13 13 13 11 13 13 13 13 13 13 13 13 10 10 10 10 10 10 10 10 10 10 10 10 10 10 10 10 10 10 10 10 10 13 13 13 13 13 13 13 13
13 13 13 13 13 13 13 13 11 13 13 13 11 13 13 13 13 13 13 13 13 13 10 10 10 13 13 13 13 13 13 13 13 13 10 10 10 10 10 10 10 10 13 13 13 13 13 13 13 13
13 13 13 13 13 13 13 13 11 13 13 13 11 13 13 13 13 13 13 13 13 13 13 10 13 13 13 13 13 13 13 13 13 13 10 10 10 10 10 10 10 10 13 13 13 13 13 13 13 13
13 13 13 13 13 13 13 13 11 11 10 11 11 13 13 13 13 13 13 13 13 13 13 10 13 13 13 13 13 13 13 13 13 13 10 10 10 10 10 10 10 10 13 13 13 13 13 13 13 13
13 13 13 13 13 13 13 13 13 13 10 13 13 13 13 13 13 13 13 13 13 13 13 10 13 13 13 13 13 13 13 13 13 13 13 10 10 10 10 10 10 13 13 13 13 13 13 13 13 13
13 13 13 13 13 13 13 13 13 13 10 13 13 13 13 13 13 13 13 13 13 13 13 10 13 13 13 13 13 13 13 13 13 13 13 13 13 13 10 13 13 13 13 13 13 13 13 13 13 13
13 13 13 13 13 13 13 13 13 13 10 13 13 13 13 13 13 13 13 13 13 13 13 10 13 13 13 13 13 13 13 13 13 13 13 13 13 13 10 13 13 13 13 13 13 13 13 13 13 13
13 13 13 13 13 13 13 13 13 13 10 13 13 13 13 13 13 13 13 13 13 13 13 10 13 13 13 13 13 13 13 13 13 13 13 13 13 13 10 13 13 13 13 13 13 13 13 13 13 13
13 13 13 13 13 13 13 13 10 10 10 13 13 13 13 13 13 13 13 13 13 13 13 10 13 13 13 13 13 13 13 13 13 13 13 13 13 13 10 13 13 13 13 13 13 13 13 13 13 13
13 13 13 13 13 13 13 13 10 13 13 13 13 13 13 13 13 13 13 13 13 13 13 10 13 13 13 13 13 13 13 13 13 13 13 13 13 13 10 13 13 13 13 13 13 13 13 13 13 13
13 13 13 13 13 13 13 13 10 13 13 13 13 13 13 13 13 13 13 13 13 13 10 10 10 13 13 13 13 13 13 13 13 13 13 13 10 10 10 13 13 13 13 13 13 13 13 13 13 13
13 13 13 13 13 13 13 13 10 13 13 13 13 13 13 13 13 13 13 13 13 10 10 10 10 10 13 13 13 13 13 13 13 13 13 13 10 13 13 13 13 13 13 13 13 13 13 13 13 13
13 13 13 13 13 13 13 13 10 13 13 13 13 13 13 13 13 13 13 13 10 10 10 10 10 10 10 13 13 13 13 13 13 13 13 10 10 13 13 13 13 13 13 13 13 13 13 13 13 13
13 13 13 13 13 13 13 13 10 13 13 13 10 10 10 10 10 10 10 10 10 10 10 10 10 10 10 10 10 10 10 10 10 10 10 10 10 13 13 13 13 13 13 13 13 13 13 13 13 13
13 13 13 13 13 13 13 13 10 13 13 13 10 13 13 13 13 13 13 13 10 10 10 10 10 10 10 13 13 13 13 13 13 13 13 13 10 13 13 13 13 13 13 13 13 13 13 13 13 13
13 13 13 13 13 13 13 13 10 13 13 13 10 13 13 13 13 13 13 13 13 10 10 10 10 10 13 13 13 13 13 13 13 13 13 13 10 13 13 13 13 13 13 13 13 13 13 13 13 13
13 13 13 13 13 13 13 13 10 13 13 13 10 13 13 13 13 13 13 13 13 13 10 10 10 13 13 13 13 13 13 13 13 13 13 13 10 13 13 13 13 13 13 13 13 13 13 13 13 13
13 13 13 13 13 13 13 13 10 13 13 13 10 10 10 13 13 13 13 13 13 13 13 10 13 13 13 13 13 13 13 13 13 13 13 13 10 13 13 13 13 13 13 13 13 13 13 13 13 13
13 13 13 13 13 13 13 13 10 13 13 13 13 13 10 13 13 13 13 13 13 13 13 10 13 13 13 13 13 13 13 13 13 13 13 13 10 13 13 13 13 13 13 13 13 13 13 13 13 13
13 13 13 13 13 13 13 13 10 13 13 13 13 13 10 13 13 13 13 13 13 13 13 10 13 13 13 10 13 13 13 13 13 13 13 10 10 13 13 13 13 13 13 13 13 13 13 13 13 13
13 13 13 13 13 13 13 13 10 13 13 13 13 13 10 13 13 13 13 13 13 13 13 10 13 13 13 13 13 13 10 13 13 13 13 13 10 13 13 13 13 13 13 13 13 13 13 13 13 13
13 13 13 13 13 13 13 13 10 10 10 10 10 10 10 13 13 13 13 13 13 13 13 10 13 13 13 13 13 13 10 13 13 13 13 13 10 13 13 13 13 13 13 13 13 13 13 13 13 13
13 13 13 13 13 13 13 13 10 10 10 10 10 10 10 13 13 13 13 13 13 13 13 10 13 13 13 13 13 13 13 13 13 13 13 13 10 13 13 13 13 13 13 13 13 13 13 13 13 13
13 13 13 13 13 13 13 13 10 10 10 10 10 10 10 13 13 13 13 13 13 13 13 10 13 13 13 13 13 13 13 13 13 13 13 10 10 10 13 13 13 13 13 13 13 13 13 13 13 13
13 13 13 13 13 13 13 13 10 10 10 10 10 10 10 13 13 13 13 13 13 13 13 10 13 13 13 13 13 13 13 13 13 13 13 10 10 10 13 13 13 13 13 13 13 13 13 13 13 13
13 13 13 13 13 13 13 13 10 10 10 10 10 10 10 13 13 13 13 13 13 13 13 10 13 13 13 13 13 13 13 13 13 13 13 10 10 10 13 13 13 13 13 13 13 13 13 13 13 13
13 13 13 13 13 13 13 13 10 10 10 10 10 10 10 13 13 13 13 13 13 13 13 10 13 13 13 13 13 13 13 13 13 13 13 10 10 10 13 13 13 13 13 13 13 13 13 13 13 13
13 13 13 13 13 13 13 13 13 13 13 13 13 13 13 13 13 13 13 13 13 13 13 10 13 13 13 13 13 13 13 13 13 13 13 10 10 10 13 13 13 13 13 13 13 13 13 13 13 13
13 13 13 13 13 13 13 13 13 13 13 13 13 13 13 13 13 13 13 10 10 10 10 10 10 10 10 13 13 13 13 13 13 13 10 10 10 10 10 13 13 13 13 13 13 13 13 13 13 13
13 13 13 13 13 13 13 13 13 13 13 13 13 13 13 13 13 13 10 10 10 10 10 10 10 10 10 10 13 13 10 13 13 10 10 10 10 10 10 13 13 13 13 13 13 13 13 13 13 13
13 13 13 13 13 13 13 13 13 13 13 13 13 13 13 13 13 13 10 10 10 10 10 10 10 10 10 10 13 13 13 13 10 10 10 10 10 10 10 13 13 13 13 13 13 13 13 13 13 13
13 13 13 13 13 13 13 13 13 13 13 13 13 10 13 13 13 13 10 10 10 10 10 10 10 10 10 10 10 13 13 13 10 10 10 10 10 13 10 13 13 13 13 13 13 13 13 13 13 13
13 13 13 13 13 13 13 13 13 13 13 13 13 13 13 13 13 13 10 10 10 10 10 10 10 10 10 10 10 10 10 10 10 10 13 10 10 10 10 13 13 13 13 13 13 13 13 13 13 13
13 13 13 13 13 13 13 13 13 13 13 13 13 10 13 13 13 13 13 10 10 10 10 10 10 10 10 13 13 13 13 10 10 10 10 10 10 10 10 13 13 13 13 13 13 13 13 13 13 13
13 13 13 13 13 13 13 13 13 13 13 13 13 13 13 13 13 13 13 13 10 10 10 10 10 10 13 13 13 13 13 10 10 13 10 10 13 10 10 13 13 13 13 13 13 13 13 13 13 13
13 13 13 13 13 13 13 13 13 13 13 13 13 13 13 13 13 13 13 13 13 13 13 13 13 13 13 13 13 13 13 13 10 10 10 10 10 10 13 13 13 13 13 13 13 13 13 13 13 13
13 13 13 13 13 13 13 13 13 13 13 13 13 13 13 13 13 13 13 13 13 13 13 13 13 13 13 13 13 13 13 13 13 13 13 13 13 13 13 13 13 13 13 13 13 13 13 13 13 13
13 13 13 13 13 13 13 13 13 13 13 13 13 13 13 13 13 13 13 13 13 13 13 13 13 13 13 13 13 13 13 13 13 13 13 13 13 13 13 13 13 13 13 13 13 13 13 13 13 13
13 13 13 13 13 13 13 13 13 13 13 13 13 13 13 13 13 13 13 13 13 13 13 13 13 13 13 13 13 13 13 13 13 13 13 13 13 13 13 13 13 13 13 13 13 13 13 13 13 13
13 13 13 13 13 13 13 13 13 13 13 13 13 13 13 13 13 13 13 13 13 13 13 13 13 13 13 13 13 13 13 13 13 13 13 13 13 13 13 13 13 13 13 13 13 13 13 13 13 13
13 13 13 13 13 13 13 13 13 13 13 13 13 13 13 13 13 13 13 13 13 13 13 13 13 13 13 13 13 13 13 13 13 13 13 13 13 13 13 13 13 13 13 13 13 13 13 13 13 13
13 13 13 13 13 13 13 13 13 13 13 13 13 13 13 13 13 13 13 13 13 13 13 13 13 13 13 13 13 13 13 13 13 13 13 13 13 13 13 13 13 13 13 13 13 13 13 13 13 13